EA ./asset/pics/eagle.xpm
SO ./asset/pics/mossy.xpm
WE ./asset/pics/wood.xpm
NO ./asset/pics/redbrick.xpm

C 0,0,155
F 149,69,19
100000000000000000000000000000000000001
100000000000000000000000000000000000001
111111111111111111111111111111111111111
100000000000000000000000000000000000001
100000000000000000000000000000000000001
100000000000000000000000000000000000001
100000000000000000000000000000000000001
100000000000000000000000000000000000001
100000000000000000000000000000000000001
100000000000000000000000000000000000001
100000000000000000000000000000000000001
1000000000000000000000000000000000S0001
100011111111111110000000000000000000001
100010000000000010000000000000000000001
100010000000000010000000000000000000001
100010000000000010000000000000000000001
100010000000000010000000000000000000001
100010000000000010000000000000000000001
100010000000000010000000000000000000001
100010000000000010000000000000000000001
100010000000000010000000000000000000001
100011111110001110000000000000000000001
100000000000000000000000000000000000001
100000000000000000000000000000000000001
100000000000000000000000000000000000001
100000000000000000000000000000000000001
100000000000000000000000000000000000001
100000000000000000000000000000000000001
100000000000000000000000000000000000001
100000000000000000000000000000000000001
100000000000000000000000000000000000001
100000000000000000000000000000000000001
111111111111111111111111111111111111111

