EA ./asset/pics/redbrick.xpm
WE ./asset/pics/bluestone.xpm
SO ./asset/pics/eagle.xpm
NO ./asset/pics/mossy.xpm

F 220,100,0
C 125,30,155

        1111111111111111111111111
        1000000000110000000000001
        101100000111000000000001
        1001000000000C0000000001
111111111011000001110000000000001
100000000011000001111011111111111
11110111111111011100000010001
11110111111111011101010010001
1000001101010111000000010001
10000000000000001100100010001
10000000000000001101010000001
1100000111010101111101111000111
11110111 1110101 101111010001
11111111 1111111 111111111111
