NO ./asset/pics/redbrick.xpm
SO ./asset/pics/mossy.xpm
WE ./asset/pics/wood.xpm
EA ./asset/pics/eagle.xpm

F 149,69,19
C 0,0,355
111111111111111111111111111111111111111111111111111111111111111111111111111111111111111111111111111111111111111111111111111111111111111
100000000000000000000000000000000000001
100000000000000000000000000000000000001
100000000000000000000000000000000000001
100000000000000000000000000C00000000001
100000000000000000000000000000000000001
100000000000000000000000000000000000001
100000000000000000000000000000000000001
100000000000000000000000000000000000001
100000000000000000000000000000000000001
100000000000000000000000000000000000001
1000000000000000000000000000000000S0001
100011111111111110000000000000000000001
100010000000000010000000000000000000001
100010000000000010000000000000000000001
100010000000000010000000000000000000001
100010000000000010000000000000000000001
100010000000000010000000000000000000001
100010000000000010000000000000000000001
100010000000000010000000000000000000001
100010000000000010000000000000000000001
100011111110001110000000000000000000001
100000000000000000000000000000000000001
100000000000000000000000000000000000001
100000000000000000000000000000000000001
100000000000000000000000000000000000001
100000000000000000000000000000000000001
100000000000000000000000000000000000001
100000000000000000000000000000000000001
100000000000000000000000000000000000001
100000000000000000000000000000000000001
100000000000000000000000000000000000001
111111111111111111111111111111111111111
F -3,3,3
C 2,2,2
hdslkdhhdslkdhhdslkdhhdslkdhhdslkdhhdslkdh
ddddddddddddddddddddddddddddddddddddddd
hdslkdh
